Mess
9,7,2
2,0,2,3,22,2,0
5,0,0,4,5,2,0
1,14,20,102,1,30,1,1,1
12,0,14,13,14,16,1,1,102
18,12,14,17,18,1,1,1,1
18,12,14,17,18,1,1,1,1
18,12,14,17,18,1,1,1,1
18,12,14,17,18,1,1,1,1
18,12,14,17,18,1,1,1,1
32,1,22,1,1,13,1,1,1