Crossroads
7,7,4
3,0,2,5,15,2,0
3,6,4,1,15,2,2
1,4,6,3,15,2,2
5,2,0,3,15,2,0
1,1,14,20,1,1,1
1,1,1,14,31,1,1
17,1,1,14,1,50,1
53,18,13,12,13,16,41
1,42,1,14,0,1,1
1,1,23,14,1,15,1
1,102,1,32,13,1,1