Forest shaper
9,7,2
2,0,2,6,10,3,0
5,0,0,1,20,2,0
1,1,20,1,1,30,1,1,1
33,18,12,12,12,16,1,1,1
1,17,16,0,18,1,1,102,1
1,1,12,1,1,1,1,1,1
18,1,14,1,17,1,1,1,1
1,1,14,17,1,102,1,1,1
1,1,22,1,1,1,1,1,1