Forest shaper
9,7,2
2,0,1,6,5,3,0
5,0,0,6,20,2,0
1,14,20,102,1,30,1,1,1
12,0,14,13,14,16,1,1,102
18,1,14,17,18,1,1,1,1
18,1,14,17,18,1,1,1,1
18,1,14,17,18,1,1,1,1
18,1,14,17,18,1,1,1,1
32,23,1,1,1,13,1,1,1